11111111111111
1000000000C001
100P0000000001
1000000C0000E1
10000000000001
10C0000000C001
11111111111111